  #####    
  #   #    
### . #    
#   . #####
# ##$## @ #
#   . $   #
###$  #####
  #   #    
  #####    