##########
#        #
#   @ .  #
#     $  #
#        #
##### ####
#     #  #
#   $ #  #
#  .  #  #
##########