#######
# $.  #
#. .$.#
#$.*. #
# $*$ #
#  .  #
# $*$ #
#  * @#
#######