##########
#        #
#   @    #
# $   $  #
#   .    #
####     #
#   $ #. #
#     #  #
#  .  #  #
##########