##########
#   .$   #
# $## ## #
# .@ $   #
#    .#  #
##########